30 15
==============================
=            |+              =
=  -----   -----  ------  |  =
=      |                  |  =
=----  ------  ------  ----  =
=              |        |    =
=  |------|  |---  ---  |  --=
=  |      |  |      |   |    =
=  |  --  |     |      ----  =
=      |  |------------|     =
=----  |  |      |     |  ---=
=      |  |  --  |  |  |     =
=  --------  |   |  |  |-----=
=            |      |       x=
==============================
